だっさい	獺祭	名詞	旭酒造((（）)山口県)
くどきじょうず	くどき上手	名詞	亀の井酒造(山形県)
がざんりゅう	雅山流	名詞	新藤酒造(山形県)
らいふく	来福	名詞	来福酒造(茨城県)
まつのことぶき	松の寿	名詞	松井酒造(栃木県)
あずまりきし	東力士	名詞	島崎酒造(栃木県)
うろこ	熟露枯	名詞	島崎酒造(栃木県)
かくれい	鶴齢	名詞	青木酒造(新潟県)
がりゅうばい	臥龍梅	名詞	三和酒造(静岡県)
こざえもん	小左衛門	名詞	中島醸造(岐阜県)
しろく	始禄	名詞	中島醸造(岐阜県)
そうげん	宗玄	名詞	宗玄酒造(石川県)
てんぐまい	天狗舞	名詞	車多酒造(石川県)
ごりん	五凛	名詞	車多酒造(石川県)
のごみ	能古見	名詞	馬場酒造場(佐賀県)
ほうくん	芳薫	名詞	馬場酒造場(佐賀県)
しちだ	七田	名詞	天山酒造(佐賀県)
あまぶき	天吹	名詞	天吹酒造合資会社(佐賀県)
だるままさむね	達磨正宗	名詞	合資会社白木恒助商店(岐阜県)
はっかいさん	八海山	名詞	八海醸造(新潟県)
いちのくら	一ノ蔵	名詞	一ノ蔵(宮城県)
まんさくのはな	まんさくの花	名詞	日の丸醸造(秋田県)
おぜのゆきどけ	尾瀬の雪どけ	名詞	龍神酒造(群馬県)
はなあび	花陽浴	名詞	南陽醸造(埼玉県)
なつざま	夏方	名詞	佐々木酒造(京都府)
すいげい	酔鯨	名詞	酔鯨酒造(高知県)
あたごのまつ	愛宕の松	名詞	新澤醸造(宮城県)
うめせんにん	梅仙人	名詞	小林酒造本店(福岡県)
べし	可	名詞	関谷醸造(愛知県)
だいしんしゅう	大信州	名詞	大信州酒造(長野県)
ますみ	真澄	名詞	宮坂醸造(長野県)
だいせっけい	大雪渓	名詞	大雪渓酒造(長野県)
ななわらい	七笑	名詞	七笑酒造(長野県)
うとう	善知鳥	名詞	西田酒造(青森県)
ひろき	飛露喜	名詞	廣木酒造本店(福島県)
すえひろ	末廣	名詞	末廣酒造(福島県)
